0 0 0 0 0 0 0 0 0 0 0 0 0 0 0 0 0 0 0 0  0 0 0 0 0 0 0 0 0 0 0 0 0 0 0 0 0 0 0 0  0 0 0 0 0 0 0 0 0 0 0 0 0 0 0 0 0 0 0 0  0 0 0 0 0 0 0 0 0 0 0 0 0 0 0 0 0 0 0 0  0 0 0 0 0 0 0 0 0 0 0 0 0 0 0 0 0 0 0 0  0 0 0 0 0 0 0 0 0 0 2 2 0 0 0 0 0 0 0 0  0 0 0 0 0 0 0 0 0 0 0 0 0 2 2 0 0 0 0 0  0 0 0 0 0 0 0 0 2 2 0 0 0 0 0 0 0 0 0 0
0 0 0 0 0 0 0 0 0 0 0 0 0 0 0 0 0 0 0 0  0 0 0 0 0 0 0 0 0 0 0 0 0 0 0 0 0 0 0 0  0 0 0 0 0 0 0 0 0 0 0 0 0 2 2 0 0 0 0 7  7 0 0 0 0 0 0 0 0 0 0 0 0 0 0 0 0 0 0 0  0 0 0 0 0 0 0 0 0 0 0 0 0 0 0 0 0 0 0 0  0 0 0 0 7 0 0 0 1 1 1 1 1 0 0 0 0 0 0 0  0 0 0 0 0 0 0 7 0 0 0 0 1 1 1 0 0 0 0 0  0 0 7 0 0 0 1 1 1 1 0 0 0 0 0 1 0 0 6 0
0 0 0 0 0 0 0 0 0 0 0 0 0 0 2 0 0 0 0 7  7 0 0 0 0 0 0 0 0 0 7 7 0 0 0 1 0 0 1 0  0 0 0 0 0 0 0 0 7 0 0 0 1 1 1 1 0 0 1 1  1 1 0 0 0 0 0 0 0 0 0 0 0 0 0 0 2 2 0 0  0 0 0 0 0 0 0 0 0 0 0 0 1 0 0 0 2 2 0 0  0 0 0 0 1 0 0 0 0 0 0 0 3 1 0 7 0 0 0 0  2 0 0 0 0 0 0 1 7 0 0 0 0 0 3 1 0 0 0 0  0 0 1 7 0 0 0 0 0 3 1 1 1 0 0 3 1 1 1 1
0 0 0 0 0 0 7 7 0 0 0 0 0 1 1 1 0 0 1 1  1 1 0 0 0 0 0 0 0 0 1 1 0 0 1 3 0 0 3 1  1 0 0 0 0 0 0 0 1 7 0 0 0 0 0 0 0 0 0 0  0 0 0 0 0 0 0 0 0 7 0 0 0 0 1 1 1 1 0 0  0 0 0 0 0 0 7 0 0 0 0 1 3 0 0 1 1 1 1 0  0 0 0 0 3 1 0 0 0 0 0 0 0 3 1 1 1 0 0 1  1 1 0 0 0 0 0 3 1 7 0 0 0 0 0 0 0 0 0 0  0 0 3 1 0 0 0 0 0 0 0 0 0 0 0 0 0 0 0 0
0 0 0 0 0 1 1 1 1 0 0 0 0 0 0 0 0 0 0 0  0 3 0 0 0 0 0 0 0 1 3 3 0 0 0 0 0 0 0 0  3 0 0 0 0 0 0 0 3 1 7 7 0 0 0 0 0 0 0 0  0 0 0 0 0 0 0 0 0 1 0 0 0 0 0 0 0 3 1 1  0 0 0 0 0 0 1 0 7 0 0 0 0 0 0 0 0 0 3 0  0 0 0 0 3 3 1 0 0 0 7 0 0 0 0 0 0 0 0 0  0 0 0 0 0 0 0 3 3 1 0 0 0 0 7 0 0 0 0 0  0 0 0 0 0 0 1 0 0 0 0 0 0 7 7 7 0 0 0 0
0 0 0 0 0 0 0 0 0 0 0 0 1 1 0 0 0 0 0 0  0 3 0 0 2 2 0 0 1 3 3 3 0 0 0 0 0 0 0 0  3 0 0 2 2 0 0 0 3 3 1 1 0 0 0 7 0 0 0 0  0 0 0 1 7 7 7 0 0 0 0 0 0 1 1 0 0 0 0 0  7 7 7 0 0 0 0 0 1 0 7 0 0 0 0 0 0 0 3 1  1 0 0 0 0 0 0 0 0 0 1 0 0 0 0 0 0 0 0 0  0 0 0 0 0 0 0 0 0 0 0 0 0 7 1 0 0 0 0 0  0 0 0 0 0 1 3 1 0 0 0 0 0 1 1 1 0 0 0 0
0 0 0 0 0 0 0 0 0 0 0 1 3 3 0 0 0 0 0 0  0 3 1 1 1 1 1 1 3 3 3 3 0 0 0 0 0 0 0 0  3 1 1 1 1 1 0 0 0 0 0 0 0 0 0 1 0 0 0 0  0 0 0 3 1 1 1 0 0 0 2 0 1 3 3 0 0 0 0 0  1 1 1 0 0 0 0 0 0 0 1 0 7 0 0 0 0 0 0 0  3 0 0 0 0 0 0 0 0 1 3 1 0 0 0 7 0 0 0 0  0 0 0 0 0 0 0 0 0 0 0 0 7 1 3 0 0 0 0 0  1 0 0 0 0 0 0 0 0 0 1 0 0 0 0 0 0 0 0 1
0 0 0 0 2 2 0 0 0 0 1 3 3 3 0 0 0 0 0 0  0 0 0 0 0 0 0 0 0 0 0 0 0 0 0 0 0 0 0 0  0 0 0 0 0 3 0 7 7 0 2 2 0 0 1 3 0 0 0 0  0 0 0 0 0 0 3 1 1 1 1 1 3 0 0 0 0 0 0 0  0 0 3 0 0 0 0 0 0 0 0 0 1 0 0 0 0 0 0 0  3 0 0 7 7 0 0 0 0 0 0 0 0 0 7 1 0 0 0 0  0 0 0 0 0 2 2 0 0 0 0 0 1 3 3 0 0 0 0 0  3 0 0 0 0 0 0 0 0 0 0 0 0 0 0 0 0 0 1 3
0 1 1 1 1 1 1 0 0 0 0 0 0 0 0 0 0 0 0 0  0 0 0 0 0 0 0 0 0 0 0 0 0 0 0 0 0 0 0 0  0 0 0 0 0 3 1 1 1 1 1 1 1 1 3 3 0 0 0 0  0 0 0 0 0 0 0 0 0 0 0 0 0 0 0 0 0 0 0 0  0 0 3 0 0 2 2 0 0 0 0 0 0 0 0 0 1 1 0 0  3 1 1 1 1 1 1 0 0 2 2 0 0 0 1 3 0 0 0 0  0 0 0 1 1 1 1 1 0 0 0 0 0 0 0 0 0 0 0 0  3 0 0 0 0 0 0 0 0 0 0 0 0 7 7 0 0 1 3 3
0 3 3 3 3 3 3 0 0 0 0 0 0 0 0 0 0 0 0 0  0 0 0 0 0 0 0 0 0 0 0 0 0 0 0 0 0 0 0 0  0 0 0 0 0 0 0 0 0 0 0 0 0 0 0 0 0 0 0 0  0 0 0 0 0 0 0 0 0 0 0 0 0 0 0 0 0 0 0 0  0 0 1 1 1 1 1 1 1 1 7 7 7 2 0 1 3 3 0 0  0 0 0 0 0 0 3 1 1 1 1 1 1 1 3 0 0 0 0 0  0 0 0 0 0 0 0 0 0 0 0 0 0 0 0 0 0 0 0 0  3 1 1 0 0 1 1 0 2 2 0 0 0 1 1 0 0 0 0 0
0 0 0 0 0 0 0 0 0 0 0 0 0 0 0 0 0 0 0 0  0 0 0 0 0 0 0 0 0 0 0 0 0 0 0 0 0 0 0 0  0 0 0 0 0 0 0 0 0 0 0 0 0 0 0 0 0 0 0 0  0 0 0 0 0 0 0 0 0 0 0 0 0 0 0 0 0 0 0 0  0 0 0 0 0 0 0 0 0 3 1 1 1 1 1 3 3 3 0 0  0 0 0 0 0 0 0 0 0 0 0 0 0 0 0 0 0 0 0 0  0 0 0 0 0 0 0 0 0 0 0 0 0 0 0 0 0 0 0 0  0 0 0 0 0 3 3 1 1 1 1 1 1 3 3 0 0 0 0 0